aristotle	greek
balzac	french
beethoven	german
caesar	roman
confucius	chinese
copernicus	polish
darwin	english/british
depp	american
descartes	french
dickens	english/british
dostoyevsky	russian
edison	american
einstein	jewish/german/american
euclid	greek
fermi	italian
galilei	italian
gorbachev	soviet/russian
hawking	english/british
hegel	german
hitler	german/austrian
homer	greek
hume	scottish/british
jolie	american
kant	german
kepler	german
lavoisier	french
leibniz	german
lenin	soviet/russian
lennon	english/british
lincoln	american
locke	english/british
machiavelli	italian
marx	german
maxwell	scottish/british
mencius	chinese
michelangelo	italian
mozart	german/austrian
napoleon	french/corsican/italian
newton	english/british
pascal	french
plato	greek
raphael	italian
rousseau	french
spinoza	dutch
stalin	soviet/georgian
strauss	austrian
tchaikovsky	russian
tolstoi	russian
truman	american
wagner	german