ape	baby/infant
badger	kit/cob
bear	cub
beaver	kit/kitten
bee	larva
beetle	larva
buffalo	calf
butterfly	larva/pupa/caterpillar/chrysalis
camel	calf/colt
cat	kitten
cattle	calf/heifer
chimpanzee	baby/infant
cicada	nymph
cockroach	nymph
cricket	larva
deer	fawn
dog	puppy/pup/whelp
duck	duckling
elephant	calf
ferret	kit
fish	fingerling/spawn/egg/larva/fry/minnmow
fly	grub/maggot
fox	cub/pup/puppy/whelp
goat	kid
goldfish	fingerling/fry
gorilla	infant
herring	fingerling/fry
horse	foal/colt/filly
insect	larva
lion	cub
mink	kit/cub
monkey	infant
muskrat	kit
ox	calf/stot
panda	cub
pig	piglet/shoat/farrow
rabbit	bunny
raccoon	kit/cub
salmon	smolt
seal	pup
shark	cub/pup
sheep	lamb/lambkin/cosset
skunk	kit/kitten
snake	hatchling/nestling
tiger	cub
trout	fingerling
weasel	kit
whale	calf
wolf	cub/pup/puppy/whelp
woodchuck	kit/cob