ant	anthill/insectarium/terrarium/formicarium
ape	grove/tree/cage
baboon	grove/tree/cage
bat	cave/cage
bear	den/cage
beaver	dam/river/pen
bee	hive
cattle	barn/coral
chimpanzee	grove/tree/cage
chinchilla	nest/cage
cockroach	nest
cricket	nest
crocodile	river/lake/pool
crow	nest/cage
dog	doghouse/home/den/kennel
dolphin	sea/sanctuary
duck	pond/nest
fish	sea/lake/river/acquarium/farm/sanctuary
fly	nest
fox	den/cage
goldfish	pond/bowl/aquarium/sanctuary
gorilla	grove/tree/cage
hamster	nest/cage
hedgehog	nest/hedge/pen
herring	sea/sanctuary
hippopotamus	river/lake/pen
hornet	nest
horse	stable/range/paddock/corral
insect	nest/cage/box
lion	den/cage/savannah
locust	nest
mallard	nest/pond
mole	hole/nest
monkey	tree/grove/cage
mouse	nest/cage
pig	sty/pigsty/pen/pigpen
rabbit	burrow/warren/hutch/cage
rat	nest/cage
raven	nest/cage
scorpion	nest/aquarium/terrarium
seal	den/aquarium/sea
snake	nest/pit/acquarium
spider	web/acquarium/terrarium
termite	hill/terrarium
tiger	den/cage
trout	river/lake/sanctuary/aquarium/pond/tank
wasp	nest
whale	sea/sanctuary
wolf	den/cage
woodchuck	hole