allosaurus	dinosaur/reptile/bird/archosaur/archosaurian/archosaurian_reptile/
anaconda	snake/reptile/boa/serpent/ophidian
ant	insect/invertebrate/creature/beast/hymenopteran/being/animal/organism/fauna/arthropod/hymenopterous_insect/animate_being/physical_hymenopteron/physical_entity/hymenopter/living_thing
beaver	rodent/vertebrate/creature/beast/animal/organism/fauna/placental/chordate/eutherian/mammal/mammalian/eutherian_mammal/gnawer/animate_being/living_thing/placental_mammal/craniate/
bee	insect/invertebrate/creature/beast/hymenopteran/being/animal/insect/organism/fauna/arthropod/hymenopterous_insect/animate_being/hymenopteron/hymenopter/living_thing
beetle	insect/invertebrate/creature/beast/being/animal/insect/organism/fauna/arthropod/animate_being/living_thing
buffalo	bovid/mammal/bison/cow/vertebrate/creature/ungulate/beast/being/animal/organism/fauna/placental/artiodactyl/ruminant/chordate/eutherian/mammalian/bovine/animate_being/eutherian_mammal/placental_mammal/craniate/physical_hoofed_mammal/physical_entity/even-toed_ungulate/artiodactyl_mammal/living_thing
butterfly	insect/creature/beast/lepidopteran/animal/organism/fauna/arthropod/lepidopterous_insect/lepidopteron/animate_being/living_thing
cat	feline/beast/animal/organism/fauna/placental/carnivore/chordate/felid/eutherian/mammal/mammalian/eutherian_mammal/animate_being/placental_mammal/craniate/
chicken	fowl/bird/vertebrate/poultry/creature/beast/being/animal/organism/fauna/poultry/chordate/domestic_fowl/animate_being/gallinaceous_bird/craniate/gallinacean/living_thing
chimpanzee	primate/vertebrate/creature/beast/being/animal/organism/fauna/placental/hominid/chordate/eutherian/mammal/ape/mammalian/animate_being/eutherian_mammal/placental_mammal/craniate/physical_physical_entity/living_thing
chinchilla	rodent/vertebrate/creature/beast/animal/organism/fauna/placental/chordate/eutherian/mammal/mammalian/eutherian_mammal/gnawer/animate_being/living_thing/placental_mammal/craniate/
cobra	snake/reptile/elapid/elapid_snake/serpent/ophidian
cockroach	insect/invertebrate/creature/beast/dictyopterous_insect/being/animal/organism/fauna/arthropod/animate_being/physical_entity/living_thing
cow	bovid/mammal/cattle/vertebrate/creature/ungulate/beast/being/animal/organism/fauna/placental/artiodactyl/ruminant/chordate/eutherian/mammalian/animate_being/eutherian_mammal/placental_mammal/craniate/physical_hoofed_mammal/physical_entity/even-toed_ungulate/artiodactyl_mammal/living_thing
coyote	canine/vertebrate/creature/beast/canid/being/animal/organism/fauna/placental/carnivore/chordate/eutherian/mammal/mammalian/animate_being/eutherian_mammal/locomote/placental_mammal/craniate/domesticated_animal/physical_entity/domestic_animal/living_thing
deer	bovid/mammal/vertebrate/creature/ungulate/beast/being/animal/organism/fauna/placental/artiodactyl/ruminant/chordate/eutherian/mammalian/bovine/animate_being/eutherian_mammal/placental_mammal/craniate/physical_hoofed_mammal/physical_entity/even-toed_ungulate/artiodactyl_mammal/living_thing
dog	canine/vertebrate/creature/beast/canid/being/animal/organism/fauna/placental/carnivore/chordate/eutherian/mammal/mammalian/animate_being/eutherian_mammal/locomote/placental_mammal/craniate/domesticated_animal/physical_entity/domestic_animal/living_thing
duck	fowl/bird/vertebrate/poultry/creature/beast/being/animal/organism/fauna/poultry/chordate/domestic_fowl/waterfowl/water_fowl/animate_being/anseriform_bird/craniate/living_thing
eagle	raptor/bird/vertebrate/creature/beast/being/animal/organism/fauna/chordate/animate_being/craniate/iving_thing/raptorial_bird/bird_of_prey/
falcon	raptor/bird/vertebrate/creature/beast/being/animal/organism/fauna/chordate/animate_being/craniate/living_thing/raptorial_bird/bird_of_prey/
fox	canine/vertebrate/creature/beast/canid/being/animal/organism/fauna/placental/carnivore/chordate/eutherian/mammal/mammalian/animate_being/eutherian_mammal/locomote/placental_mammal/craniate/domesticated_animal/physical_entity/domestic_animal/living_thing
gibbon	primate/vertebrate/creature/beast/being/animal/organism/fauna/placental/chordate/eutherian/mammal/ape/mammalian/animate_being/eutherian_mammal/placental_mammal/craniate/physical_physical_entity/living_thing
goat	bovid/mammal/vertebrate/ungulate/beast/being/animal/organism/fauna/placental/artiodactyl/chordate/eutherian/mammalian/animate_being/eutherian_mammal/placental_mammal/craniate/hoofed_mammal/even-toed_ungulate/artiodactyl_mammal/living_thing
goose	fowl/bird/vertebrate/poultry/creature/beast/being/animal/organism/fauna/poultry/chordate/domestic_fowl/waterfowl/water_fowl/animate_being/anseriform_bird/craniate/living_thing
gorilla	primate/vertebrate/creature/beast/being/animal/organism/fauna/placental/hominid/chordate/eutherian/mammal/ape/mammalian/animate_being/eutherian_mammal/placental_mammal/craniate/physical_physical_entity/living_thing
hawk	raptor/bird/vertebrate/creature/beast/being/animal/organism/fauna/chordate/animate_being/craniate/living_thing/raptorial_bird/bird_of_prey/
human	primate/vertebrate/creature/beast/being/animal/organism/fauna/placental/hominid/chordate/eutherian/mammal/ape/mammalian/animate_being/eutherian_mammal/placental_mammal/craniate/physical_physical_entity/living_thing
jackal	canine/vertebrate/creature/beast/canid/being/animal/organism/fauna/placental/carnivore/chordate/eutherian/mammal/mammalian/animate_being/eutherian_mammal/locomote/placental_mammal/craniate/domesticated_animal/physical_entity/domestic_animal/living_thing
jaguar	feline/cat/beast/animal/organism/fauna/placental/carnivore/chordate/felid/eutherian/mammal/mammalian/eutherian_mammal/animate_being/placental_mammal/craniate/big_cat
leopard	feline/cat/beast/animal/organism/fauna/placental/carnivore/causal_agent/chordate/felid/eutherian/mammal/mammalian/eutherian_mammal/animate_being/placental_mammal/craniate/big_cat
lion	feline/cat/beast/animal/organism/fauna/placental/carnivore/chordate/felid/eutherian/mammal/mammalian/eutherian_mammal/animate_being/placental_mammal/craniate/big_cat
mamba	snake/reptile/elapid/elapid_snake/serpent/ophidian
mouse	rodent/vertebrate/creature/beast/animal/organism/fauna/placental/chordate/eutherian/mammal/mammalian/eutherian_mammal/gnawer/animate_being/living_thing/placental_mammal/craniate/
orangutan	primate/vertebrate/creature/beast/being/animal/organism/fauna/placental/hominid/chordate/eutherian/mammal/ape/mammalian/animate_being/eutherian_mammal/placental_mammal/craniate/physical_physical_entity/living_thing
owl	raptor/bird/vertebrate/creature/beast/being/animal/organism/fauna/chordate/animate_being/craniate/living_thing/raptorial_bird/bird_of_prey/
pony	bovid/mammal/horse/vertebrate/creature/beast/animal/organism/fauna/placental/eutherian/mammal/equine/mammalian/equid/living_thing/odd-toed_ungulate/animate_being/eutherian_mammal/perissodactyl/placental_mammal/craniate/hoofed_mammal/physical_entity/perissodactyl_mammal/equus_caballus
porcupine	rodent/vertebrate/creature/beast/animal/organism/fauna/placental/chordate/eutherian/mammal/mammalian/eutherian_mammal/gnawer/animate_being/living_thing/placental_mammal/craniate/
quail	fowl/bird/vertebrate/poultry/creature/beast/being/animal/organism/fauna/poultry/chordate/wild_fowl/wildfowl/animate_being/gallinaceous_bird/craniate/gallinacean/living_thing
rattlesnake	snake/reptile/pit_viper/serpent/ophidian
squirrel	rodent/vertebrate/creature/beast/animal/organism/fauna/placental/chordate/eutherian/mammal/mammalian/eutherian_mammal/gnawer/animate_being/living_thing/placental_mammal/craniate/
stegosaurus	dinosaur/reptile/armored_dinosaur/archosaur/archosaurian/archosaurian_reptile/
tiger	feline/cat/beast/animal/organism/fauna/placental/carnivore/chordate/felid/eutherian/mammal/mammalian/eutherian_mammal/animate_being/placental_mammal/craniate/big_cat
triceratops	dinosaur/reptile/ceratopsian/horned_dinosaur/archosaur/archosaurian/archosaurian_reptile/
turkey	fowl/bird/vertebrate/poultry/creature/beast/being/animal/organism/fauna/poultry/chordate/domestic_fowl/animate_being/gallinaceous_bird/craniate/gallinacean/living_thing
tyrannosaurus	dinosaur/reptile/theropod/theropod_dinosaur/bird-footed_dinosaur/archosaur/archosaurian/archosaurian_reptile/
velociraptor	dinosaur/reptile/maniraptor/archosaur/archosaurian/archosaurian_reptile/
viper	snake/reptile/snake/serpent/ophidian
vulture	raptor/bird/vertebrate/creature/beast/being/animal/organism/fauna/chordate/animate_being/craniate/living_thing/raptorial_bird/bird_of_prey/
wolf	canine/vertebrate/creature/beast/canid/being/animal/organism/fauna/placental/carnivore/chordate/eutherian/mammal/mammalian/animate_being/eutherian_mammal/locomote/placental_mammal/craniate/domesticated_animal/physical_entity/domestic_animal/living_thing