armchair	chair/seat/piece_of_furniture/article_of_furniture/furnishing/artifact/artefact/unit/object/physical_object/physical_entity/entity
blender	appliance/mixer/kitchen_utensil/utensil/implement/artifact/artefact/unit/object/physical_object/physical_entity/entity
bracelet	jewelry/band/strip/slip/artifact/artefact/unit/object/physical_object/physical_entity/entity/jewellery/adornment/decoration/ornament/ornamentation/artifact/artefact/unit/object/physical_object/physical_entity/entity
brooch	jewelry/jewellery/adornment/decoration/ornament/ornamentation/artifact/artefact/unit/object/physical_object/
cake	dessert/baked_goods/food/solid_food/course/nutriment/nourishment/nutrition/sustenance/aliment/alimentation/victuals/food/nutrient/substance/matter/physical_entity/entity
computer	device/machine/gadget/artifact/artefact/unit/object/physical_object/physical_entity/entity/expert/person/individual/someone/somebody/mortal/soul/causal_agent/cause/causal_agency/organism/being/physical_entity/living_thing/animate_thing/entity/unit/object/physical_object/
croissant	pastry/bun/roll/bread/breadstuff/staff_of_life/baked_goods/starches/food/solid_food/foodstuff/food_product/solid/food/nutrient/matter/substance/physical_entity/entity
cup	tableware/crockery/dishware/ware/article/artifact/artefact/unit/object/physical_object/physical_entity/entity/container
denim	fabric/cloth/material/textile/artifact/artefact/unit/object/physical_object/physical_entity/entity/garment/clothing/article_of_clothing/vesture/wear/wearable/habiliment/consumer_goods/covering/commodity/trade_good/good/artifact/artefact/unit/object/physical_object/physical_entity/entity
deodorant	toiletry/toilet_articles/artifact/artefact/unit/object/physical_object/physical_entity/entity
desk	furniture/table/piece_of_furniture/article_of_furniture/furnishing/artifact/artefact/unit/object/physical_object/physical_entity/entity
diary	journal/writing/written_material/piece_of_writing/written_communication/written_language/black_and_white/communication/abstraction/abstract_entity/entity/journal/book/volume/product/production/creation/artifact/artefact/unit/object/physical_object/physical_entity/entity
dishwasher	appliance/machine/entity/unit/object/physical_object/white_goods/home_appliance/household_appliance/durables/durable_goods/consumer_durables/consumer_goods/commodity/trade_good/good/artifact/artefact/unit/object/physical_object/physical_entity/entity
dress	clothes/garment/clothing/article_of_clothing/vesture/wear/wearable/habiliment/consumer_goods/covering/commodity/trade_good/good/artifact/artefact/unit/object/physical_object/physical_entity/entity/
fridge	appliance/icebox/white_goods/home_appliance/household_appliance/appliance/durables/durable_goods/consumer_durables/consumer_goods/commodity/trade_good/good/artifact/artefact/unit/object/physical_object/physical_entity/entity
gasoline	fuel/hydrocarbon/substance/organic_compound/matter/compound/chemical_compound/physical_entity/chemical/chemical_substance/entity/material/stuff/substance/part/portion/component_part/component/constituent/relation/abstraction/abstract_entity
grapefruit	citrus/citrus_fruit/citrous_fruit/fruit/edible_fruit/fruit/produce/green_goods/green_groceries/garden_truck/food/matter/natural_object/physical_entity/unit/entity/object/physical_object
hairnet	net/network/mesh/meshing/meshwork/fabric/cloth/material/textile/artifact/artefact/unit/object/physical_object/physical_entity/entity
hairpin	pin/fastener/fastening/holdfast/fixing/restraint/constraint/device/artifact/artefact/unit/object/physical_object/physical_entity/entity
hamburger	sandwich/snack_food/dish/nutriment/nourishment/nutrition/sustenance/aliment/alimentation/victuals/food/nutrient/substance/matter/physical_entity/entity/beef/boeuf/meat/food/solid_food/solid/matter/physical_entity/entity
jacket	clothes/coat/overgarment/outer_garment/garment/clothing/article_of_clothing/vesture/wear/wearable/habiliment/consumer_goods/covering/commodity/trade_good/good/artifact/artefact/unit/object/physical_object/physical_entity/entity/
jeans	trousers/pants/workwear/garment/clothing/clothes/article_of_clothing/vesture/wear/wearable/habiliment/consumer_goods/covering/commodity/trade_good/good/artifact/artefact/unit/object/physical_object/physical_entity/entity/
juicer	utensil/physical_entity/entity/unit/object/physical_object/squeezer/kitchen_utensil/implement/artifact/artefact/unit/object/physical_object/physical_entity/entity
lemon	citrus/citrus_fruit/citrous_fruit/fruit/edible_fruit/fruit/produce/green_goods/green_groceries/garden_truck/food/matter/natural_object/physical_entity/unit/entity/object/physical_object
lotion	toiletry/toilet_articles/artifact/artefact/unit/object/physical_object/physical_entity/entity/
mascara	makeup/make-up/war_paint/cosmetic/toiletry/toilet_articles/artifact/artefact/unit/object/physical_object/physical_entity/entity
necklace	jewelry/jewellery/adornment/decoration/ornament/ornamentation/artifact/artefact/unit/object/physical_object/physical_entity/entity
notebook	book/volume/product/production/creation/artifact/artefact/unit/object/physical_object/physical_entity/entity/portable_computer/personal_computer/pc/microcomputer/digital_computer/computer/computing_machine/computing_device/data_processor/electronic_computer/information_processing_system/machine/device/artifact/artefact/unit/object/physical_object/physical_entity/entity
notepad	pad/pad_of_paper/tablet/paper/material/stuff/substance/matter/part/portion/component_part/component/constituent/physical_entity/relation/entity/abstraction/abstract_entity
pastry	food/dough/concoction/mixture/intermixture/foodstuff/food_product/food/nutrient/substance/matter/physical_entity/entity/baked_goods/solid_food/solid/matter/physical_entity/entity
peach	fruit/drupe/stone_fruit/edible_fruit/fruit/produce/green_goods/green_groceries/garden_truck/food/matter/natural_object/physical_entity/unit/entity/object/physical_object
perfume	toiletry/toilet_articles/artifact/artefact/unit/object/physical_object/physical_entity/entity
photo	picture/image/representation/creation/artifact/artefact/unit/object/physical_object/physical_entity/entity
pie	pastry/baked_goods/food/solid_food/solid/matter/physical_entity/entity/indo-european/indo-european_language/indo-hittite/natural_language/tongue/language/linguistic_communication/communication/abstraction/abstract_entity/entity
plum	fruit/drupe/stone_fruit/edible_fruit/fruit/produce/green_goods/green_groceries/garden_truck/food/matter/natural_object/physical_entity/unit/entity/object/physical_object
postcard	card/correspondence/first_class/1st_class/first-class_mail/1st-class_mail/written_communication/written_language/black_and_white/mail/communication/message/abstraction/abstract_entity/entity
shelf	furniture/support/piece_of_furniture/article_of_furniture/furnishing/artifact/artefact/unit/object/physical_object/physical_entity/entity
shirt	clothes/garment/clothing/garment/clothing/article_of_clothing/vesture/wear/wearable/habiliment/consumer_goods/covering/commodity/trade_good/good/artifact/artefact/unit/object/physical_object/physical_entity/entity/
sidewalk	walk/walkway/paseo/path/way/artifact/artefact/unit/object/physical_object/physical_entity/entity
skirt	clothes/garment/clothing/garment/clothing/article_of_clothing/vesture/wear/wearable/habiliment/consumer_goods/covering/commodity/trade_good/good/artifact/artefact/unit/object/physical_object/physical_entity/entity/
sofa	furniture/seat/piece_of_furniture/article_of_furniture/furnishing/artifact/artefact/unit/object/physical_object/physical_entity/entity
stapler	device/machine/artifact/artefact/unit/object/physical_object/physical_entity/entity
sunscreen	cream/lotion/ointment/emollient/toiletry/toilet_articles/artifact/artefact/unit/object/physical_object/physical_entity/entity
sweater	clothes/garment/clothing/article_of_clothing/vesture/wear/wearable/habiliment/consumer_goods/covering/commodity/trade_good/good/artifact/artefact/unit/object/physical_object/physical_entity/entity/
toaster	appliance/entity/unit/object/physical_object/kitchen_appliance/home_appliance/household_appliance/durables/durable_goods/consumer_durables/consumer_goods/commodity/trade_good/good/artifact/artefact/unit/object/physical_object/physical_entity/entity
toothbrush	brush/toiletry/toilet_articles/implement/artifact/artefact/unit/object/physical_object/physical_entity/entity/mustache/moustache/facial_hair/hair/body_covering/covering/natural_covering/cover/natural_object/unit/object/physical_object/physical_entity/entity
tub	container/vessel/artifact/artefact/unit/object/physical_object/physical_entity/entity
tv	device/machine/receiver/receiving_system/set/electronic_equipment/equipment/artifact/artefact/unit/object/physical_object/physical_entity/entity/broadcasting/telecommunication/telecom/medium/artifact/artefact/unit/object/physical_object/physical_entity/entity
vase	jar/vessel/container/artifact/artefact/unit/object/physical_object/physical_entity/entity
wristband	band/strip/slip/artifact/artefact/unit/object/physical_object/physical_entity/entity/band/strip/slip/artifact/artefact/unit/object/physical_object/physical_entity/entity